"","epic","hero","licensed_content_video_games","war","city","story","action","evil","enemy","weapon","the_earth","team_group_crew_squad","licensed_content_cultural_products","army","human_race_mankind","level_stage","magic","puzzle","mystery"
"644272",1,1,1,1,1,1,0,0,0,0,0,0,0,0,0,0,0,0,0
"672717",0,0,1,0,0,0,1,1,0,0,0,0,0,0,0,0,0,0,0
"683187",0,0,0,0,0,0,0,0,1,1,0,0,0,0,0,0,0,0,0
"722936",1,0,0,0,0,0,0,1,0,0,1,1,1,0,0,0,0,0,0
"723569",0,0,0,0,0,1,0,0,0,0,1,0,0,1,1,0,0,0,0
"730735",0,0,0,1,0,0,0,0,0,0,0,0,0,0,0,0,0,0,0
"735149",0,0,0,0,0,1,0,0,0,0,0,0,0,0,0,0,0,0,0
"739464",0,0,0,0,0,0,1,0,0,0,0,0,0,0,0,0,0,0,0
"739681",0,0,0,0,0,0,0,0,0,0,0,0,1,0,0,0,0,0,0
"762884",0,0,0,0,0,1,1,0,0,0,0,0,1,0,0,0,0,0,0
"763436",1,0,0,0,0,0,0,0,1,0,1,0,0,0,0,0,0,0,0
"768265",0,0,0,0,0,0,0,1,1,0,0,0,0,0,0,1,0,0,0
"809372",0,1,0,0,0,0,0,0,1,1,0,0,1,0,0,0,1,1,0
"813891",0,0,0,0,0,0,0,0,0,0,0,0,0,0,0,0,0,0,1
"826286",0,0,0,1,0,0,0,0,0,0,0,0,0,0,0,0,0,0,0
