"","enemy","magic","shoot","soldier","licensed_content_video_games","war","just_name","team_group_crew_squad","attack","army","weapon","the_earth","death","mystery","level_stage","story","fast","licensed_content_cultural_products","strategy_tactics","action"
"930092",1,1,0,0,0,0,0,0,0,0,0,0,0,0,0,0,0,0,0,0
"932655",1,0,1,1,1,0,0,0,0,0,0,0,0,0,0,0,0,0,0,0
"932999",0,0,0,0,0,1,1,1,0,0,0,0,0,0,0,0,0,0,0,0
"935183",0,0,0,1,0,1,0,0,1,1,1,1,0,0,0,0,0,0,0,0
"936936",0,0,0,1,0,0,1,0,0,1,0,0,0,0,0,0,0,0,0,0
"937709",1,0,0,0,0,0,0,1,0,0,1,0,1,1,0,0,0,0,0,0
"938058",0,0,0,0,0,0,1,0,0,1,0,0,0,0,1,1,1,0,0,0
"942650",0,0,0,0,0,0,1,0,0,0,0,0,0,0,0,0,0,1,1,1
