"","kill","just_name","army","war","soldier","enemy","hero","weapon","story","mystery","destroy_devastate_wreck","action","battle","the_earth"
"945597",1,1,1,1,0,0,0,0,0,0,0,0,0,0
"958985",0,0,1,0,1,1,0,0,0,0,0,0,0,0
"960103",0,0,0,0,0,0,1,1,1,0,0,0,0,0
"960638",0,0,1,1,0,0,0,0,1,1,0,0,0,0
"961100",0,0,1,0,0,0,0,0,0,0,0,0,0,0
"971353",0,0,1,0,0,1,0,0,0,0,1,0,0,0
"974789",0,0,1,0,1,0,0,0,0,0,0,1,1,0
"985981",0,0,0,1,0,1,0,0,0,0,0,0,0,1
