"","dangerous","level_stage","fast","enemy","evil","puzzle","action","magic","hero"
"942016",1,1,0,0,0,0,0,0,0
"942135",0,0,1,0,0,0,0,0,0
"944900",0,1,0,1,1,1,0,0,0
"945804",0,1,0,0,0,0,0,0,0
"946472",0,0,0,1,0,0,1,0,0
"953017",0,0,0,0,0,1,0,0,0
"954262",0,0,0,1,1,0,0,1,1
"954304",0,1,0,0,0,0,0,0,0
