"","dangerous","mystery","epic","story","puzzle","enemy","licensed_content_video_games","city","army","magic","hero","licensed_content_cultural_products","horde_wave_mass","human_race_mankind","action","weapon","team_group_crew_squad","level_stage","battle","the_earth"
"605302",1,0,0,0,0,0,0,0,0,0,0,0,0,0,0,0,0,0,0,0
"609595",0,1,1,1,1,1,0,0,0,0,0,0,0,0,0,0,0,0,0,0
"615426",0,1,0,0,0,0,1,1,0,0,0,0,0,0,0,0,0,0,0,0
"618245",0,1,0,1,0,0,0,1,0,0,0,0,0,0,0,0,0,0,0,0
"618770",1,1,1,1,1,0,0,0,0,0,0,0,0,0,0,0,0,0,0,0
"628357",1,0,0,0,0,0,1,0,1,0,0,0,0,0,0,0,0,0,0,0
"631936",0,0,0,0,0,0,0,0,0,1,1,1,0,0,0,0,0,0,0,0
"640253",0,0,0,0,0,1,0,1,0,0,0,1,1,0,0,0,0,0,0,0
"944089",0,0,0,0,0,0,0,0,0,0,0,0,0,1,0,0,0,0,0,0
"952594",0,0,1,0,1,1,0,1,1,1,0,0,0,0,1,1,0,0,0,0
"954855",0,0,0,0,0,0,1,1,0,0,0,0,0,0,0,0,0,0,0,0
"960633",0,0,0,0,0,0,1,0,0,0,0,0,0,0,0,0,0,0,0,0
"974869",0,0,0,1,0,0,0,0,0,0,0,0,0,0,0,0,0,0,0,0
"981375",0,0,0,1,0,0,0,1,0,0,0,1,0,0,0,0,0,0,0,0
"988768",0,0,0,0,0,0,0,0,0,0,0,1,0,0,0,0,1,1,1,0
"989945",0,0,0,0,0,1,0,1,0,0,1,0,0,1,0,0,0,0,0,0
"996489",0,0,0,1,0,0,0,0,0,0,0,0,0,0,0,1,0,0,0,1
