"","tournament_competition","realistic_accurate","enemy","move_special_move","team_group_crew_squad","action","strategy_tactics","fast"
"960521",1,1,1,0,0,0,0,0
"960629",0,1,0,0,0,0,0,0
"971262",1,0,0,1,0,0,0,0
"973379",0,1,1,0,1,0,0,0
"981301",1,1,0,0,0,1,0,0
"985985",1,1,1,0,1,0,0,0
"986258",1,0,0,0,1,0,0,0
"988954",0,1,0,0,0,0,1,0
"988956",0,1,0,0,0,0,0,0
"991333",0,0,1,0,0,0,0,1
"991753",1,0,1,0,1,1,0,0
"995950",0,1,0,0,0,0,0,0
