"","just_name","puzzle","story","challenge","music","enemy","evil","level_stage","army","team_group_crew_squad"
"605744",1,1,1,0,0,0,0,0,0,0
"614182",0,1,1,1,0,0,0,0,0,0
"620580",0,0,0,0,1,0,0,0,0,0
"630993",1,0,1,0,0,1,1,1,1,0
"632666",0,1,0,0,0,0,0,0,0,0
"991326",1,1,0,0,0,1,0,1,0,1
