"","licensed_content_cultural_products","city","kill","evil","friend","destroy_devastate_wreck","just_name","challenge","team_group_crew_squad","action","mystery","survive","story"
"622370",1,1,1,0,0,0,0,0,0,0,0,0,0
"632677",0,0,1,1,1,1,1,0,0,0,0,0,0
"640836",0,1,0,0,0,0,0,0,0,0,0,0,0
"652585",1,0,0,0,0,0,0,1,0,0,0,0,0
"659951",1,0,0,0,0,0,0,0,1,0,0,0,0
"659955",0,0,0,1,0,0,1,0,1,1,0,0,0
"669580",0,0,0,0,0,0,0,0,0,0,1,0,0
"691380",1,0,0,0,0,0,0,0,0,0,0,1,1
