"","action","enemy","weapon","destroy_devastate_wreck","epic","team_group_crew_squad","move_special_move","realistic_accurate","war","battle","army","attack","story","fast","fight","human_race_mankind","the_earth","tournament_competition","evil"
"666759",1,0,0,0,0,0,0,0,0,0,0,0,0,0,0,0,0,0,0
"681609",0,1,1,1,0,0,0,0,0,0,0,0,0,0,0,0,0,0,0
"718285",0,1,1,0,1,1,1,1,1,1,1,0,0,0,0,0,0,0,0
"718642",1,1,0,0,0,0,0,0,1,0,0,1,1,1,0,0,0,0,0
"722789",0,0,0,0,0,0,0,0,0,0,0,0,0,0,1,0,0,0,0
"730869",0,0,0,0,0,0,0,0,1,0,0,0,1,0,0,1,0,0,0
"739683",0,0,0,0,0,1,0,0,0,0,0,0,0,0,0,0,1,1,0
"766676",0,1,0,0,0,0,0,0,0,0,0,0,0,0,0,1,0,0,0
"783734",0,0,1,1,0,0,0,0,0,0,0,0,0,0,0,0,0,0,1
