"","just_name","realistic_accurate","tournament_competition","licensed_tournament","race","team_group_crew_squad","hero","enemy","fast","arcade"
"698630",1,1,1,0,0,0,0,0,0,0
"734964",0,1,1,1,1,0,0,0,0,0
"739660",0,0,1,1,0,1,1,0,0,0
"786046",0,1,0,0,1,1,0,1,0,0
"799987",0,0,0,0,1,0,0,0,0,0
"824823",0,0,1,1,0,0,0,0,1,0
"872798",0,0,0,0,0,1,0,1,0,0
"887306",0,0,0,0,0,0,0,1,0,1
