"","dangerous","story","team_group_crew_squad","action","enemy","tournament_competition","realistic_accurate"
"615810",1,1,1,0,0,0,0
"632147",0,0,0,1,0,0,0
"640098",0,0,0,0,1,0,0
"645152",0,0,0,0,0,1,1
"647145",0,0,1,0,1,1,0
"649290",0,0,0,0,0,1,1
"656451",0,0,1,0,0,1,0
"656452",0,0,0,0,0,0,1
"661935",0,0,0,0,0,0,1
"664912",0,0,0,0,0,0,1
"668444",0,0,1,0,0,1,1
"672341",0,1,0,0,0,0,0
"672372",0,0,1,0,0,0,0
