"","hero","horde_wave_mass","action","story","enemy","weapon","epic","puzzle","city","level_stage","fast","the_earth","dangerous"
"605452",1,1,1,0,0,0,0,0,0,0,0,0,0
"605803",0,0,0,1,0,0,0,0,0,0,0,0,0
"606312",0,0,0,0,1,1,0,0,0,0,0,0,0
"615804",0,0,0,1,0,0,1,0,0,0,0,0,0
"618630",0,1,0,0,0,0,0,1,1,0,0,0,0
"629692",0,1,1,0,0,0,0,0,0,1,0,0,0
"630113",1,0,0,0,1,0,0,0,0,0,1,0,0
"991348",1,0,0,0,0,0,0,0,0,0,0,1,1
