"","level_stage","race","mystery","adventure","puzzle","evil"
"959832",1,1,0,0,0,0
"971669",1,0,1,1,0,0
"974804",1,0,0,0,1,0
"978737",1,0,0,0,1,0
"979375",1,0,0,0,0,0
"980488",0,0,0,0,0,1
