"","licensed_content_video_games","level_stage","enemy","the_earth","evil","magic","story","mystery","licensed_content_cultural_products","puzzle"
"632974",1,1,1,0,0,0,0,0,0,0
"640250",0,0,1,1,1,0,0,0,0,0
"647271",0,0,0,0,0,1,0,0,0,0
"665234",0,0,0,0,0,0,1,1,0,0
"671548",0,0,0,0,1,0,0,0,0,0
"671549",0,0,0,0,1,0,0,0,0,0
"672908",0,0,0,0,0,0,0,0,1,0
"672909",0,0,0,1,0,0,0,0,1,1
"673026",0,0,0,0,0,1,1,0,1,0
"676740",0,1,0,0,0,0,0,0,0,0
