"","just_name","licensed_content_cultural_products","level_stage","puzzle","rescue","story","mystery","action","collect_gather","adventure","team_group_crew_squad","kill","death","army","shoot","magic","licensed_content_video_games","city"
"622897",1,1,1,1,0,0,0,0,0,0,0,0,0,0,0,0,0,0
"628141",0,1,0,0,1,0,0,0,0,0,0,0,0,0,0,0,0,0
"630328",1,0,0,0,0,1,1,0,0,0,0,0,0,0,0,0,0,0
"632836",1,1,0,1,0,0,1,1,1,1,0,0,0,0,0,0,0,0
"638951",0,1,0,0,0,1,0,1,0,0,1,1,0,0,0,0,0,0
"640910",1,1,0,0,0,0,0,0,0,0,0,0,1,0,0,0,0,0
"647153",0,0,0,1,0,1,0,0,0,0,0,0,0,1,1,1,0,0
"958041",1,0,0,1,0,0,0,0,0,0,0,0,0,0,0,0,1,0
"988983",1,0,0,0,0,0,1,1,0,0,0,1,0,0,0,0,0,1
