"","hero","city","evil","puzzle","war","enemy","epic","army","weapon","human_race_mankind","licensed_content_cultural_products","story","team_group_crew_squad","licensed_content_video_games","mystery","level_stage","magic","strategy_tactics"
"929198",1,1,1,0,0,0,0,0,0,0,0,0,0,0,0,0,0,0
"942025",1,1,1,1,0,0,0,0,0,0,0,0,0,0,0,0,0,0
"942350",0,0,0,1,0,0,0,0,0,0,0,0,0,0,0,0,0,0
"943672",0,0,0,0,1,1,1,1,1,1,1,0,0,0,0,0,0,0
"952337",0,1,0,0,0,1,0,0,0,0,1,0,0,0,0,0,0,0
"954263",0,1,0,0,0,0,0,0,1,0,0,1,1,1,0,0,0,0
"955125",0,1,0,0,0,1,0,1,0,0,0,0,0,1,1,0,0,0
"956191",1,0,0,0,0,0,1,0,0,0,0,0,0,0,0,0,0,0
"956856",0,0,0,0,0,1,1,0,0,0,0,0,0,1,0,0,0,0
"958890",0,0,0,0,0,0,0,0,1,0,0,0,1,0,0,0,0,0
"959196",0,1,0,0,0,1,0,0,0,0,0,0,0,0,1,0,0,0
"978268",0,0,0,1,0,0,0,0,0,0,0,0,0,0,1,1,1,1
