"","story","realistic_accurate","mystery","puzzle","adventure","attack","hero","army","enemy","licensed_content_cultural_products","level_stage","tournament_competition","weapon"
"605047",1,1,1,0,0,0,0,0,0,0,0,0,0
"940007",0,0,1,0,0,0,0,0,0,0,0,0,0
"952385",0,0,0,1,0,0,0,0,0,0,0,0,0
"954373",0,0,0,0,1,1,0,0,0,0,0,0,0
"974820",0,0,0,0,0,1,1,1,1,0,0,0,0
"977601",0,0,0,1,0,0,0,0,0,1,0,0,0
"980069",0,0,1,0,0,0,0,0,0,0,0,0,0
"980070",1,0,0,0,0,0,0,0,0,0,0,0,0
"991496",0,0,1,0,0,0,0,1,0,0,0,0,0
"994624",1,0,0,0,0,0,0,0,0,0,1,1,0
"997381",0,0,1,0,0,0,0,0,0,0,1,0,1
"997603",0,0,0,0,0,0,0,0,1,0,0,0,0
