"","enemy","puzzle","dangerous","level_stage","fast","licensed_content_video_games","evil","tournament_competition","epic","team_group_crew_squad","action","shoot","licensed_content_cultural_products","weapon","mystery","magic","hero","the_earth","destroy_devastate_wreck","attack"
"937398",1,1,0,0,0,0,0,0,0,0,0,0,0,0,0,0,0,0,0,0
"941995",1,1,0,0,0,0,0,0,0,0,0,0,0,0,0,0,0,0,0,0
"942016",0,0,1,1,0,0,0,0,0,0,0,0,0,0,0,0,0,0,0,0
"942135",0,0,0,0,1,0,0,0,0,0,0,0,0,0,0,0,0,0,0,0
"943660",0,0,0,0,0,1,1,0,0,0,0,0,0,0,0,0,0,0,0,0
"944900",1,1,0,1,0,0,1,0,0,0,0,0,0,0,0,0,0,0,0,0
"945273",0,0,0,1,0,0,0,1,0,0,0,0,0,0,0,0,0,0,0,0
"945458",1,0,0,0,0,0,0,0,1,0,0,0,0,0,0,0,0,0,0,0
"945804",0,0,0,1,0,0,0,0,0,0,0,0,0,0,0,0,0,0,0,0
"945858",0,0,0,0,0,0,0,0,0,1,1,0,0,0,0,0,0,0,0,0
"946021",0,0,0,0,0,0,0,0,0,0,0,1,0,0,0,0,0,0,0,0
"946119",0,0,0,0,0,0,0,0,0,0,0,0,1,0,0,0,0,0,0,0
"946431",0,0,0,0,0,0,0,0,0,0,0,0,0,1,0,0,0,0,0,0
"946472",1,0,0,0,0,0,0,0,0,0,1,0,0,0,0,0,0,0,0,0
"946762",1,1,0,0,0,0,0,0,0,0,0,0,0,0,0,0,0,0,0,0
"950884",0,0,0,0,0,0,0,0,0,0,0,0,1,0,0,0,0,0,0,0
"952258",0,1,0,0,0,0,0,0,0,0,0,0,0,0,0,0,0,0,0,0
"953017",0,1,0,0,0,0,0,0,0,0,0,0,0,0,0,0,0,0,0,0
"953031",0,0,0,0,1,0,0,1,0,0,0,0,0,0,0,0,0,0,0,0
"953908",0,0,0,1,0,0,0,0,0,0,1,0,0,0,0,0,0,0,0,0
"953912",0,0,0,0,0,0,1,0,0,0,0,0,0,0,1,1,0,0,0,0
"954047",0,1,0,0,0,0,0,0,0,0,0,0,0,0,1,0,0,0,0,0
"954262",1,0,0,0,0,0,1,0,0,0,0,0,0,0,0,1,1,0,0,0
"954294",1,0,0,0,0,0,0,0,0,0,0,0,0,0,0,0,0,0,0,0
"954304",0,0,0,1,0,0,0,0,0,0,0,0,0,0,0,0,0,0,0,0
"954407",0,0,0,0,0,0,0,0,0,0,0,0,0,0,0,1,0,1,1,0
"954724",0,0,0,1,0,0,0,0,0,0,0,0,0,0,0,0,0,0,0,0
"955068",1,1,0,1,0,0,0,0,0,0,0,0,0,0,1,0,0,0,0,0
"955261",1,1,0,1,0,0,1,0,0,0,0,0,0,0,0,1,0,0,0,1
"955661",0,1,0,0,1,0,0,0,0,0,1,0,0,0,0,0,0,0,0,0
