"","tournament_competition","realistic_accurate","enemy","weapon","licensed_content_video_games","story","team_group_crew_squad","shoot"
"928289",1,1,0,0,0,0,0,0
"930863",0,0,1,0,0,0,0,0
"930953",1,0,0,0,0,0,0,0
"932196",0,1,1,0,0,0,0,0
"932465",1,1,1,1,1,1,0,0
"932715",0,1,0,0,0,0,0,0
"932932",0,0,0,0,0,0,1,0
"932993",1,0,0,0,0,0,0,0
"933142",0,0,1,0,0,0,1,0
"935290",0,0,0,0,0,0,1,1
