"","realistic_accurate","tournament_competition","race","team_group_crew_squad","hero","enemy","fast"
"698630",1,1,0,0,0,0,0
"734964",1,1,1,0,0,0,0
"739660",0,1,0,1,1,0,0
"786046",1,0,1,1,0,1,0
"799987",0,0,1,0,0,0,0
"824823",0,1,0,0,0,0,1
"872798",0,0,0,1,0,1,0
"887306",0,0,0,0,0,1,0
