"","tournament_competition","realistic_accurate","licensed_tournament","fight","defend","story"
"690620",1,1,1,0,0,0
"691940",1,1,0,0,0,0
"697675",0,0,1,0,0,0
"702679",0,0,1,0,0,0
"711378",0,1,1,1,1,0
"711402",0,0,0,0,0,1
"713750",0,0,1,0,0,0
"717252",0,0,0,0,1,0
