"","just_name","destroy_devastate_wreck","team_group_crew_squad","mystery","race","city","realistic_accurate","action","enemy","licensed_content_video_games","licensed_content_cultural_products","licensed_tournament","tournament_competition","compete","defend"
"944908",1,1,1,1,1,1,0,0,0,0,0,0,0,0,0
"946195",0,0,0,0,0,0,1,0,0,0,0,0,0,0,0
"949120",0,0,0,0,0,0,1,1,0,0,0,0,0,0,0
"949453",0,0,0,0,0,0,1,0,0,0,0,0,0,0,0
"950923",0,0,0,0,0,0,1,0,0,0,0,0,0,0,0
"954363",0,0,0,0,0,0,0,0,1,1,0,0,0,0,0
"955340",0,1,0,0,0,0,1,0,1,0,0,0,0,0,0
"958262",0,0,0,0,0,0,0,0,0,0,1,1,1,0,0
"958432",0,0,0,0,0,0,1,0,0,0,0,0,1,0,0
"958702",0,0,0,0,0,0,1,0,0,0,0,1,0,0,0
"958704",0,0,0,0,0,0,0,0,0,0,0,1,1,0,0
"959013",0,0,0,0,0,0,1,0,0,0,0,1,1,0,0
"959188",0,0,0,0,0,0,0,0,0,0,0,1,0,0,0
"959291",0,0,0,0,0,0,1,0,0,0,0,1,0,1,0
"959972",0,0,1,0,0,0,1,0,1,0,0,1,1,0,1
"960292",0,0,0,0,0,0,1,0,0,1,0,0,0,0,0
"960358",0,0,0,0,0,0,1,0,0,0,0,1,1,0,0
