"","licensed_content_video_games","story","magic","action","war","evil","hero","destroy_devastate_wreck","dangerous","enemy","city","human_race_mankind","team_group_crew_squad","epic","battle","licensed_content_cultural_products","mystery","horde_wave_mass","the_earth","weapon","army"
"928447",1,1,0,0,0,0,0,0,0,0,0,0,0,0,0,0,0,0,0,0,0
"930253",0,0,1,1,1,0,0,0,0,0,0,0,0,0,0,0,0,0,0,0,0
"938603",0,0,1,0,0,1,1,1,0,0,0,0,0,0,0,0,0,0,0,0,0
"943228",0,1,1,0,1,1,1,0,1,1,0,0,0,0,0,0,0,0,0,0,0
"946789",0,0,0,0,0,1,1,0,0,0,1,0,0,0,0,0,0,0,0,0,0
"946860",0,0,0,0,1,0,0,0,0,0,0,1,1,0,0,0,0,0,0,0,0
"950918",0,1,0,0,1,1,0,0,0,1,0,1,0,1,1,0,0,0,0,0,0
"951210",0,0,0,0,1,0,0,0,0,1,0,0,0,0,0,1,0,0,0,0,0
"954342",0,0,0,0,0,0,1,0,0,0,0,0,0,0,0,0,1,0,0,0,0
"954343",0,0,0,0,1,1,1,1,0,0,0,1,0,0,0,0,0,1,0,0,0
"954345",0,0,1,0,0,1,0,0,0,0,0,1,0,0,0,0,1,1,0,0,0
"958279",0,1,0,0,0,0,0,0,0,1,0,0,0,0,0,0,1,0,0,0,0
"958463",0,0,0,0,0,1,0,0,0,0,0,0,0,0,0,0,0,0,1,0,0
"960801",1,1,0,0,0,1,0,0,0,0,0,0,0,1,0,0,0,0,0,1,1
