"","story","war","team_group_crew_squad","human_race_mankind","just_name","evil","horde_wave_mass","epic","realistic_accurate","enemy","city","puzzle","friend","challenge","battle","army","soldier","licensed_content_cultural_products","dangerous"
"604704",1,1,1,0,0,0,0,0,0,0,0,0,0,0,0,0,0,0,0
"605154",0,0,0,1,1,1,1,1,0,0,0,0,0,0,0,0,0,0,0
"621364",0,1,0,0,0,0,0,0,1,1,0,0,0,0,0,0,0,0,0
"626625",0,0,0,0,0,0,0,0,1,0,0,0,0,0,0,0,0,0,0
"632708",1,0,0,0,0,1,0,0,0,0,1,1,0,0,0,0,0,0,0
"639173",0,0,0,0,0,0,0,0,0,0,0,1,1,1,0,0,0,0,0
"639414",1,1,1,0,1,0,0,1,1,1,0,0,0,0,1,1,0,0,0
"996871",0,0,0,0,1,0,0,0,0,1,0,0,0,0,0,1,1,1,1
