"","enemy","battle","war","weapon","army","team_group_crew_squad","attack","realistic_accurate","action","licensed_content_cultural_products","destroy_devastate_wreck","tournament_competition","just_name","explode_blast","evil"
"606289",1,1,1,1,1,1,0,0,0,0,0,0,0,0,0
"624142",1,0,0,1,0,0,1,0,0,0,0,0,0,0,0
"632821",0,1,0,0,0,0,0,1,0,0,0,0,0,0,0
"632964",1,0,0,1,0,0,0,0,1,1,0,0,0,0,0
"651837",0,1,0,0,0,1,1,1,0,0,0,0,0,0,0
"660035",0,0,0,0,0,0,0,0,0,0,1,1,0,0,0
"672361",0,0,0,0,0,0,0,1,0,0,0,0,1,0,0
"984946",0,0,0,0,0,1,0,0,0,0,0,0,0,0,0
"997850",1,0,0,1,0,0,0,0,0,0,1,1,1,1,1
