"","city","story","attack","weapon","army","realistic_accurate","fast","destroy_devastate_wreck","war","shoot","enemy","level_stage","team_group_crew_squad"
"933195",1,0,0,0,0,0,0,0,0,0,0,0,0
"942050",0,1,1,1,0,0,0,0,0,0,0,0,0
"944262",0,0,0,1,1,0,0,0,0,0,0,0,0
"944542",0,0,0,0,1,1,0,0,0,0,0,0,0
"944916",0,1,0,0,0,0,0,0,0,0,0,0,0
"944977",0,0,0,1,0,0,1,1,1,1,0,0,0
"952621",0,0,0,0,0,0,0,0,1,0,1,1,1
"954040",0,0,0,0,0,1,0,0,0,0,0,0,0
