"","licensed_tournament","realistic_accurate","tournament_competition","music","team_group_crew_squad","story","challenge","fast"
"927449",1,1,0,0,0,0,0,0
"928262",1,0,1,0,0,0,0,0
"928263",1,0,1,1,1,0,0,0
"928296",0,0,0,0,0,1,0,0
"928316",0,0,0,0,0,1,1,0
"928333",0,1,1,0,0,0,0,0
"928412",1,0,0,0,0,0,0,0
"928463",1,1,0,0,1,0,0,0
"930852",0,0,0,0,0,0,0,1
