"","army","enemy","city","puzzle","death","weapon","magic","horde_wave_mass","just_name","hero","destroy_devastate_wreck","team_group_crew_squad","the_earth","dangerous","story","soldier"
"611752",1,1,1,1,1,0,0,0,0,0,0,0,0,0,0,0
"671116",0,0,1,0,0,0,0,0,0,0,0,0,0,0,0,0
"672368",0,1,0,0,0,1,1,1,0,0,0,0,0,0,0,0
"687861",0,0,0,0,0,0,0,0,1,0,0,0,0,0,0,0
"706748",0,1,0,0,1,0,0,1,0,1,1,1,1,0,0,0
"708479",0,1,0,0,0,0,0,0,1,0,0,0,0,1,1,0
"998291",0,0,0,0,0,0,1,0,0,0,0,0,0,0,0,1
