"","hero","enemy","evil","magic","destroy_devastate_wreck","battle","adventure","army","licensed_content_video_games","realistic_accurate","story","war","action","fast","epic","team_group_crew_squad","city","weapon","mission","level_stage"
"932515",1,1,1,1,1,1,1,0,0,0,0,0,0,0,0,0,0,0,0,0
"939208",0,0,0,0,0,0,0,1,1,1,1,1,0,0,0,0,0,0,0,0
"941684",0,0,0,0,0,0,0,0,0,0,0,0,1,1,0,0,0,0,0,0
"942139",0,0,0,0,0,0,0,0,0,0,0,0,1,0,0,0,0,0,0,0
"942165",1,0,1,0,0,0,0,0,0,0,1,1,1,0,1,1,0,0,0,0
"943657",0,0,0,1,0,0,0,0,0,0,0,0,0,0,0,0,1,0,0,0
"944932",0,0,0,0,0,0,0,1,0,0,0,1,0,0,0,0,0,1,1,0
"945393",0,0,0,0,0,0,0,0,0,0,0,1,0,0,0,0,0,0,0,0
"946839",0,0,0,0,0,0,0,0,0,0,0,0,0,0,0,0,1,0,0,1
