"","hero","battle","epic","mystery","magic","death","just_name","friend","war","army","city","mission","story"
"651582",1,1,1,0,0,0,0,0,0,0,0,0,0
"709407",1,0,0,1,1,0,0,0,0,0,0,0,0
"730866",0,0,0,1,0,1,1,0,0,0,0,0,0
"763235",0,0,0,0,0,0,1,1,1,1,1,0,0
"778830",0,0,0,0,0,0,1,0,1,0,0,1,1
