"","tournament_competition","realistic_accurate","licensed_tournament","team_group_crew_squad","fight","defend","story"
"690620",1,1,1,0,0,0,0
"691940",1,1,0,0,0,0,0
"697075",0,1,0,1,0,0,0
"697675",0,0,1,0,0,0,0
"702679",0,0,1,0,0,0,0
"704518",0,1,0,0,0,0,0
"711378",0,1,1,0,1,1,0
"711402",0,0,0,0,0,0,1
"713750",0,0,1,0,0,0,0
"717252",0,0,0,0,0,1,0
