"","mystery","puzzle","city","weapon","war","destroy_devastate_wreck","action","licensed_content_video_games","evil","horde_wave_mass","move_special_move","hero","enemy","realistic_accurate","magic","level_stage"
"930085",1,1,1,0,0,0,0,0,0,0,0,0,0,0,0,0
"930144",0,0,1,1,1,1,1,0,0,0,0,0,0,0,0,0
"932520",0,0,0,0,0,0,0,1,0,0,0,0,0,0,0,0
"932853",1,0,0,0,0,0,0,0,1,1,0,0,0,0,0,0
"932984",1,1,0,0,0,0,0,1,0,1,0,0,0,0,0,0
"935677",0,0,0,1,0,0,0,1,0,0,1,1,0,0,0,0
"938877",0,0,1,0,0,0,0,0,0,0,0,0,1,1,0,0
"940567",0,1,0,0,0,0,0,1,0,0,0,0,0,0,1,1
