"","destroy_devastate_wreck","enemy","tournament_competition","dangerous","action","realistic_accurate","fast","race","team_group_crew_squad"
"928393",1,1,0,0,0,0,0,0,0
"932101",0,0,1,1,1,0,0,0,0
"932731",0,0,0,0,0,1,1,0,0
"932810",1,0,0,0,0,1,1,0,0
"932887",0,0,1,0,0,1,0,0,0
"934329",1,0,0,0,0,0,0,0,0
"935830",0,0,0,0,0,0,0,1,0
"938502",0,0,1,0,0,1,0,0,1
