"","action","licensed_content_video_games","puzzle","horde_wave_mass","level_stage","enemy","magic","mystery","city","evil","team_group_crew_squad"
"930069",1,1,0,0,0,0,0,0,0,0,0
"944469",1,0,1,1,1,1,0,0,0,0,0
"954814",0,0,0,0,1,0,1,0,0,0,0
"957669",1,0,1,0,1,0,0,0,0,0,0
"957674",0,0,0,0,0,0,1,1,0,0,0
"958943",0,0,1,0,0,0,0,0,0,0,0
"959661",0,0,0,0,0,0,0,0,1,1,1
"960170",0,0,1,0,0,0,0,0,0,0,0
"960593",0,0,0,0,0,0,0,1,0,0,0
"971686",0,0,1,0,1,0,0,0,0,0,0
"974793",0,0,1,0,1,0,1,0,0,0,0
