"","city","battle","mystery","action","weapon","enemy","story","licensed_content_video_games","magic","epic","team_group_crew_squad","dangerous","hero","fight"
"604987",1,1,1,0,0,0,0,0,0,0,0,0,0,0
"605365",0,0,0,1,1,1,1,1,0,0,0,0,0,0
"928790",1,0,0,0,1,0,0,0,1,0,0,0,0,0
"943655",0,0,0,0,1,0,0,0,0,1,1,0,0,0
"944907",0,0,1,0,0,0,1,1,0,0,1,1,1,0
"959557",0,0,0,1,0,0,0,0,0,0,0,0,0,0
"971431",0,0,0,1,0,1,0,1,0,1,0,1,0,0
"991034",0,0,0,0,0,0,0,1,0,0,0,0,1,1
