"","weapon","licensed_content_video_games","mission","realistic_accurate","war","team_group_crew_squad","battle","enemy","story","human_race_mankind","destroy_devastate_wreck","fight","horde_wave_mass","attack","level_stage","action","mystery","evil","magic","fast","adventure"
"516508",1,1,1,0,0,0,0,0,0,0,0,0,0,0,0,0,0,0,0,0,0
"927725",0,0,0,1,1,1,1,0,0,0,0,0,0,0,0,0,0,0,0,0,0
"928233",1,0,0,0,0,1,0,1,1,1,0,0,0,0,0,0,0,0,0,0,0
"928260",0,0,0,0,0,0,0,0,1,0,0,0,0,0,0,0,0,0,0,0,0
"930740",0,0,0,0,0,0,0,0,0,0,1,0,0,0,0,0,0,0,0,0,0
"930762",0,0,0,0,0,0,0,0,0,1,0,1,1,0,0,0,0,0,0,0,0
"930838",0,0,0,0,0,0,0,1,0,0,0,0,0,1,0,0,0,0,0,0,0
"930847",0,0,0,0,0,0,0,0,0,0,0,0,0,0,1,0,0,0,0,0,0
"930848",0,0,0,0,0,0,0,0,0,0,0,0,0,0,1,1,1,0,0,0,0
"930851",0,0,0,0,0,0,0,1,0,0,0,0,1,0,0,0,0,1,0,0,0
"930856",0,0,0,0,0,0,0,1,0,0,0,0,0,0,0,0,0,0,1,1,1
