"","story","the_earth","mystery","enemy","team_group_crew_squad","hero","magic","puzzle"
"620232",1,0,0,0,0,0,0,0
"657807",0,1,1,0,0,0,0,0
"760213",1,0,0,0,0,0,0,0
"785539",0,1,1,1,1,0,0,0
"826388",0,0,1,0,0,1,0,0
"895981",1,0,1,0,0,0,1,1
